1, 5, 50, 50, 50, 50, 50, 50, 50, 50
50, 50, 50, 50, 50, 50, 50, 50, 50, 50
50, 50, 50, 50, 50, 50, 50, 50, 50, 50
50, 50, 120, 120, 50, 50, 50, 50, 50, 50
50, 50, 120, 120, 50, 50, 50, 50, 50, 50
50, 50, 120, 120, 50, 50, 50, 50, 50, 50
180, 50, 50, 50, 50, 50, 50, 135, 135, 135
180, 50, 50, 50, 50, 50, 50, 135, 135, 135
180, 50, 50, 50, 50, 50, 50, 135, 135, 135
180, 50, 50, 50, 50, 50, 50, 135, 135, 135