157, 110, 29, 134, 45, 186, 190, 96, 46, 100
136, 42, 142, 34, 12, 60, 178, 188, 34, 105
41, 148, 6, 84, 178, 153, 158, 95, 52, 62
80, 145, 101, 4, 80, 162, 176, 50, 160, 70
97, 24, 38, 96, 69, 15, 171, 12, 109, 27
118, 62, 113, 95, 105, 18, 31, 89, 162, 85
100, 65, 49, 68, 64, 127, 83, 16, 109, 80
66, 145, 9, 78, 153, 163, 62, 92, 113, 130
24, 179, 158, 141, 26, 94, 29, 121, 80, 98
141, 53, 156, 47, 139, 135, 181, 22, 160, 120